{
  "name": "Test",
  "size":{
    "height": 10,
    "width": 10
  },
  "tiles": [
    ["s", "o", "#", "o", "o", "o", "#", "o","x"],
    ["#", "o", "#", "o", "#", "o", "#", "o","#"],
    ["#", "o", "#", "o", "#", "o", "o", "o","#"],
    ["o", "o", "o", "o", "#", "o", "#", "#","#"],
    ["o", "#", "o", "#", "o", "o", "#", "#","#"],
    ["o", "#", "o", "#", "o", "#", "#", "#","#"],
    ["o", "o", "o", "#", "o", "o", "o", "o","o"],
    ["#", "#", "#", "#", "#", "#", "#", "o","#"],
    ["#", "#", "#", "#", "#", "#", "#", "o","#"],
    ["#", "#", "#", "#", "#", "#", "#", "#","#"]
  ]
}