{
  "name": "Test",
  "size":{
    "height": 10,
    "width": 10
  },
  "tiles": [
    ["s", "*", "x", "*", "*", "*", "x", "*","t"],
    ["x", "*", "x", "*", "x", "*", "x", "*","x"],
    ["x", "*", "x", "*", "x", "*", "*", "*","x"],
    ["*", "*", "*", "*", "x", "*", "x", "x","x"],
    ["*", "x", "*", "x", "*", "*", "x", "x","x"],
    ["*", "x", "*", "x", "*", "x", "x", "x","x"],
    ["*", "*", "*", "x", "*", "*", "*", "*","*"],
    ["x", "x", "x", "x", "x", "x", "x", "*","x"],
    ["x", "x", "x", "x", "x", "x", "x", "*","x"],
    ["x", "x", "x", "x", "x", "x", "x", "x","x"]
  ]
}